###############################
#A      #   #       #         #
# ####### # # ### # ####### # #
#         #     # #   #     # #
####### ######### ### # ##### #
#     #   #     # # # # #     #
# ### ##### ### # # # # # #####
# #       # # #   #     #   # #
# ####### # # # ########### # #
#       #   #   #       #   # #
# ##### ##### ### ####### ### #
#   # #   # # # # #     #   # #
### # ### # # # # # ####### # #
#   # #   #     # # #     # # #
# ### # ######### # # ### # # #
# #   #     #     # #   # #   #
# ### ##### # ##### ### # ### #
# #   #   # #     #   # #   # #
# # # ### # ##### # ### ### # #
#   #     #       #       #  B#
###############################
